###################################################
#P                                                 #
# ## # # # # # # # # # # # # # #       # # # # # #
#           #                 #       #           #
# # # # # # #         # # # # # # # # #       # ##
#     #     #         #           #   #       #   #
# # # # # # # # # # # # # # #     # # # # # # # ##
#     #           #           #       #       #   #
# # # # #         # # # # # # # # # # #       # ##
#     #       #   #           #           #       #
# # # # # # # # # #     E     #     # # # # # # ##
#     #       #   #           #           #       #
# # # # # # # # # # # # # # # # # # # #       # ##
#                 #                   #       #   #
# # # # # # # # # # # # # #     # # # # # # # # ##
#     #           #           #     #         #   #
# # # # # # # # # # # # # # # # # # # # # # # # ##
#                 #                 #             #
# # # # # # # # # # # # # # # # # # # # # # # # ##
#                                                 #
###################################################
