#####################
#P                 E#
# # # # # # # # # ##
#   #   #   #   #  #
# # # # # # # # # ##
#   #   #   #   #  #
# # # # # # # # # ##
#M  #   #   #   # M#
# # # # # # # # # ##
#   #   #   #   #  #
#####################
